xgb_cv_casual,casual_test,xgb_cv_registered,registered_test,xgb_cv_total,total_test
8.483837,8,52.001465,52,59.57987,60
7.6637945,8,21.999279,22,30.020144,30
9.14436,10,9.949781,10,20.011728,20
4.793906,5,9.949781,10,14.99822,15
1.9707155,2,8.000006,8,9.996202,10
1.0024134,1,39.008095,39,39.65702,40
1.9345279,2,146.64462,146,148.09097,148
6.506261,6,415.65277,414,419.3746,420
11.811202,12,671.9877,668,687.4722,680
20.761353,21,309.60315,310,329.0844,331
12.673932,13,132.97049,133,147.2178,146
13.294809,14,155.99051,156,170.16425,170
23.12774,23,197.80237,198,220.11563,221
49.5568,49,199.57684,199,248.46495,248
30.723785,31,153.31854,154,185.20218,185
35.179073,35,179.90396,179,213.83698,214
30.583395,31,316.44128,313,342.4915,344
36.079792,37,635.7726,652,688.6062,689
49.374256,50,635.7726,628,668.93506,678
28.04088,28,422.09503,424,454.2564,452
15.626299,16,281.94708,280,296.38583,296
28.88834,29,238.5531,238,265.5794,267
26.79598,27,174.16757,175,202.01424,202
8.032213,8,112.08769,112,119.1865,120
10.013534,10,39.008095,40,50.747486,50
4.8348494,5,18.999485,19,23.940367,24
2.8500342,3,6.999994,7,9.995213,10
0.0010849719,0,2.9569173,3,2.9979453,3
0.9853095,1,6.000832,6,6.9960566,7
1.0024649,1,24.999298,25,25.965397,26
1.9188442,2,119.94211,120,121.20015,122
7.9758162,8,350.22388,349,356.5451,357
30.821835,31,669.6877,656,694.10785,687
26.998747,27,352.8587,355,381.9452,382
20.76225,21,182.54297,183,203.82529,204
41.86313,42,179.70953,179,220.48291,221
50.466084,52,240.15009,240,293.70358,292
63.057343,64,230.40158,230,292.5855,294
62.194977,63,199.58334,199,263.00662,262
49.996967,51,257.49683,255,306.69098,306
46.998146,48,372.63184,373,419.9557,421
55.33737,57,568.4076,581,648.10913,638
32.14786,32,489.80933,490,524.03076,522
37.85478,38,339.21558,336,375.53522,374
13.594908,14,207.69543,207,220.07762,221
22.395481,23,132.96747,133,156.4126,156
13.581225,14,134.13513,135,149.68544,149
10.669954,11,108.80957,108,119.169586,119
8.745588,9,98.71103,99,108.274826,108
5.8521156,6,83.459656,83,89.072624,89
9.334614,10,35.879128,36,46.04399,46
5.777551,6,21.999279,22,27.98885,28
7.609504,8,8.000006,8,16.03554,16
0.99932057,1,8.000006,8,9.000772,9
3.8448186,4,17.000002,17,21.008741,21
0.9916164,1,57.99819,58,59.511543,59
10.2701,10,131.4838,132,142.15851,142
31.133038,31,187.89658,188,218.44331,219
62.953613,68,259.73907,260,327.2817,328
57.22762,56,283.96918,284,337.681,340
73.91847,74,319.0913,320,391.84152,394
108.443794,110,339.3629,339,447.67822,449
134.57574,136,319.40027,319,453.1094,455
118.332214,117,330.6385,331,447.27512,448
102.94465,108,293.79004,292,397.83298,400
111.43959,112,296.19446,298,411.12854,410
60.764786,58,238.30838,239,296.50366,297
21.975784,22,216.96497,217,240.65146,239
23.1328,23,158.77628,158,181.86417,181
30.92384,31,134.49155,135,165.35565,166
13.010904,13,132.97049,133,146.98848,146
15.024369,15,132.97049,133,147.85472,148
4.7565126,5,97.39462,97,101.14046,102
25.443798,26,139.09589,139,165.27052,165
5.979883,6,30.981615,31,37.001934,37
0.9898196,1,9.949781,10,11.00523,11
1.9793383,2,6.999994,7,8.995279,9
0.0010849719,0,5.000111,5,4.988392,5
1.9902034,2,14.000016,14,16.046658,16
10.346671,11,39.008095,39,50.71267,50
34.12609,34,113.79268,115,149.8003,149
54.123917,56,160.95218,161,216.3499,217
68.754135,73,286.7713,287,361.2359,360
129.98444,134,309.65192,311,447.84503,445
144.31241,150,353.0551,354,508.69623,504
113.764565,122,372.88184,371,492.59985,493
144.7214,149,361.76562,360,508.4918,509
145.04929,149,303.78864,300,447.67856,449
114.28142,119,317.1306,316,434.32953,435
54.234585,57,270.2591,270,327.1597,327
30.872772,31,207.08112,206,237.68549,237
23.366508,24,202.94217,203,228.12674,227
6.9813075,7,134.22513,134,140.3687,141
15.496417,16,71.42139,71,87.27851,87
14.197671,15,64.333176,64,79.04596,79
11.210621,12,41.008904,41,53.92068,53
3.7105107,3,20.000025,20,23.041552,23
0.10108346,0,8.000006,8,8.015869,8
1.9999843,2,3.9989676,4,5.9818463,6
0.9940325,1,2.9569173,3,4.0025096,4
4.777981,5,11.000018,11,15.8175,16
0.97427005,1,37.537514,38,39.808193,39
3.8110971,4,134.67792,135,138.37442,139
7.9858117,8,454.25592,453,462.22488,461
18.908375,19,627.2626,629,645.63806,648
17.468018,18,238.55045,239,257.87897,257
30.033037,30,112.390045,112,142.09601,142
30.521048,31,119.16171,119,149.77702,150
38.140045,38,207.08112,206,243.5236,244
39.157467,39,182.62427,183,222.06473,222
30.786758,31,164.95053,165,197.10571,196
23.87014,24,207.81491,207,231.30884,231
35.120674,35,327.956,325,361.18738,360
33.96474,34,597.2298,604,645.35754,638
19.034916,19,516.1975,523,543.937,542
10.640133,11,361.5692,361,370.0423,372
12.497924,13,228.15488,228,239.91435,241
8.567879,8,144.8263,144,151.34734,152
4.7058406,4,111.01523,111,114.677124,115
0.93395984,0,52.774178,53,54.060253,53
1.5997883,1,18.000223,18,18.984968,19
0.10108346,0,8.000006,8,8.013685,8
0.0010849719,0,2.0058706,2,1.9940075,2
-0.0073416433,0,3.9989676,4,4.024471,4
0.0010849719,0,6.999994,7,6.982338,7
0.9940117,1,39.008095,40,40.96989,41
5.7091384,6,142.98608,143,150.01381,149
9.148933,9,383.81842,378,387.62268,387
20.239561,20,561.00757,568,581.5822,588
25.226917,25,339.17938,338,365.07983,363
41.106323,41,189.7427,189,231.19482,230
39.635815,39,177.96707,177,216.06079,216
30.736094,31,217.04132,217,249.10478,248
45.568172,46,231.94,232,276.29224,278
43.324924,44,197.55484,196,240.42218,240
45.249264,45,228.57358,227,271.5277,272
32.926853,33,372.88184,369,403.706,402
29.766542,30,595.8281,597,626.82855,627
20.24382,20,477.3329,477,496.1117,497
14.461644,15,353.03827,356,370.15372,371
10.111005,10,218.64252,218,227.81442,228
14.036161,14,139.09589,137,151.70834,151
17.061651,17,135.983,136,152.92458,153
19.14795,19,187.89658,186,205.60045,205
49.3674,49,236.8046,234,282.16895,283
5.9970155,6,85.008224,86,91.77277,92
6.023627,6,67.16269,68,74.04142,74
2.007655,2,8.999781,9,10.787656,11
0.0010849719,0,8.999781,9,8.985275,9
0.0010849719,0,26.999556,27,27.004732,27
3.1127772,3,113.79268,115,118.3113,118
4.8345346,5,316.75024,314,319.4676,319
18.08734,18,561.00757,583,594.2816,601
17.005136,17,352.42554,351,370.72488,368
26.88968,27,150.81512,151,178.67743,178
14.313995,15,131.56342,132,147.16687,147
23.639242,24,187.89658,188,211.4739,212
22.677105,23,158.77628,158,181.76025,181
18.84335,19,141.92484,142,160.52914,161
20.16273,20,177.96707,178,197.14107,198
23.098608,23,249.9946,250,272.02206,273
15.738886,16,502.95935,501,515.3769,517
16.914015,17,443.31824,448,469.38058,465
16.7583,17,304.93762,302,319.321,319
7.609211,7,249.60318,249,257.2978,256
5.5365367,5,121.652954,121,126.49971,126
4.726917,4,55.987305,56,59.67133,60
3.729023,3,37.425987,37,39.394623,40
1.6058127,1,14.000016,14,14.990744,15
1.0050013,1,11.000018,11,11.99914,12
0.99990594,1,5.000111,5,5.988387,6
0.99990594,1,8.999781,9,9.761796,10
0.0010849719,0,35.000343,35,34.94786,35
1.9945815,2,121.48978,122,124.10032,124
11.479395,12,415.89325,411,425.67014,423
15.873099,16,627.2626,652,667.7761,668
22.229006,22,251.80429,253,273.97345,275
12.989569,13,150.36584,148,160.36858,161
15.843302,16,154.90652,155,170.9812,171
32.586613,33,201.46591,202,236.00748,235
32.426735,33,197.55484,195,227.95767,228
32.97907,33,150.36584,149,181.42606,182
32.146458,32,201.42136,201,233.91832,233
17.97643,18,319.37506,321,338.7163,339
35.64086,36,568.4076,556,594.367,592
15.995641,16,489.65125,491,507.14774,507
13.908267,14,361.79248,359,374.60794,373
9.66911,10,236.6322,235,246.27011,245
10.6607895,11,221.85052,222,233.6971,233
13.593114,14,146.36905,147,160.18341,161
5.557009,5,82.04646,82,87.51499,87
9.631174,9,45.686646,46,55.00435,55
3.0357068,3,17.000002,17,19.994276,20
0.99727696,1,11.000018,11,11.990588,12
3.0043936,3,6.000832,6,8.967618,9
0.0010849719,0,14.000016,14,14.013693,14
2.008216,2,24.999298,25,26.995003,27
4.878098,5,125.9852,126,129.74821,131
9.681345,9,330.3913,332,341.94443,341
25.237062,25,661.38983,668,690.7108,693
22.781097,23,305.15155,304,327.45465,327
33.909874,34,163.21793,163,197.26884,197
64.406006,66,184.3486,185,253.04102,251
46.416615,48,213.33606,214,262.9796,262
59.025345,62,238.13403,237,299.97885,299
64.12573,67,207.73273,207,274.0425,274
75.93617,78,275.28485,278,355.4027,356
55.52579,57,382.5818,377,433.8225,434
59.306454,61,603.2846,593,647.2078,654
45.21749,46,442.91882,450,495.5888,496
30.10713,30,329.8714,331,361.20377,361
19.802134,20,236.72949,235,255.05325,255
22.699917,23,177.96707,176,199.46135,199
17.27215,17,146.6525,146,162.74876,163
19.903944,20,141.92484,142,162.45978,162
15.507688,16,105.85289,106,121.25015,122
8.420869,8,67.07393,68,75.161194,76
2.6535678,2,42.43975,42,43.870506,44
8.800686,9,11.000018,11,20.091312,20
1.984648,2,3.9989676,4,6.006725,6
1.0008667,1,8.999781,9,9.998671,10
4.896795,5,11.000018,11,16.001314,16
13.284153,14,57.01625,57,71.23591,71
15.312456,16,129.93625,130,147.11824,146
46.89187,43,217.0054,216,260.36386,259
86.82542,86,262.1728,264,352.2491,350
145.39621,143,327.57532,323,467.14594,466
259.32584,258,350.22388,348,609.7078,606
263.59482,268,382.58765,383,645.9872,651
304.98495,280,350.22388,347,628.16376,627
207.00581,216,352.8587,351,567.1903,567
223.18808,227,382.58765,378,611.0322,605
181.1335,183,318.9494,318,497.9603,501
107.446945,103,257.0869,256,360.9392,359
53.24244,55,228.0651,228,282.91614,283
41.387436,39,153.11389,153,192.07167,192
49.07372,51,169.69455,169,220.55464,220
39.508297,39,153.65897,154,192.34508,193
26.053026,26,119.94211,120,146.84586,146
13.387197,14,110.003265,110,124.27318,124
25.985897,26,82.04646,82,108.2977,108
11.880188,12,58.269196,58,69.061005,70
8.851206,9,39.008095,39,46.98319,48
4.9427223,5,6.000832,6,11.022523,11
0.0010849719,0,11.998885,12,11.9988,12
2.9872203,3,15.99977,16,19.05634,19
11.484204,12,55.987305,56,68.28569,68
31.777239,32,86.99153,87,119.58991,119
87.62297,94,179.68332,179,271.81366,273
134.59541,133,274.1919,272,402.4323,405
179.21635,180,327.56494,324,507.46976,504
195.34953,195,386.56964,390,583.2162,585
265.3915,262,421.26636,424,686.1545,686
307.2193,292,361.5891,362,647.2317,654
307.22235,304,420.76868,420,713.11194,724
265.03665,260,395.91937,393,646.7165,653
152.22006,151,341.9676,342,490.7252,493
107.59248,102,304.75226,303,405.44635,405
67.46379,69,207.81372,208,277.643,277
52.066597,54,146.3497,146,200.10287,200
43.094414,44,128.89658,127,170.90567,171
20.716223,21,112.10985,113,134.25565,134
15.902813,16,92.99138,93,108.689606,109
5.7465835,6,42.148315,43,49.000164,49
4.001047,4,26.000011,26,29.964224,30
5.954061,6,14.000016,14,20.012632,20
0.99990594,1,2.9569173,3,4.0070887,4
0.99990594,1,2.9569173,3,4.0034223,4
0.99990594,1,23.000067,23,24.01005,24
6.8007464,7,64.13081,64,71.00869,71
16.071161,16,249.20068,248,262.8053,264
49.32192,50,489.33282,490,543.80756,540
57.348198,60,339.3275,337,398.3309,397
84.212,82,184.5636,184,265.90213,266
113.999886,112,257.88977,255,369.15045,367
108.284256,105,317.05524,314,419.73718,419
107.892426,108,309.73877,312,419.15945,420
135.32968,134,310.03674,310,439.4802,444
107.76466,102,281.98413,280,382.36462,382
89.408966,87,350.2437,347,434.54794,434
69.2928,66,516.42914,530,602.221,596
69.4319,65,488.86078,486,544.88184,551
41.360004,30,328.05267,323,351.9685,353
30.735603,31,273.57623,273,302.64014,304
9.682647,10,144.57034,145,154.30003,155
11.479172,12,98.71103,100,111.41948,112
1.5330862,1,61.784554,62,62.560444,63
5.2608714,5,18.000223,18,22.766037,23
0.8093166,0,5.000111,5,5.0321684,5
6.975639,7,3.9989676,4,11.000834,11
1.9847605,2,2.9569173,3,4.999914,5
0.0010849719,0,8.999781,9,9.001129,9
0.0010849719,0,18.000223,18,18.00092,18
1.9881024,2,47.69821,48,50.27417,50
0.87240446,1,105.85289,106,106.87425,107
4.6015744,4,207.78986,207,211.18283,211
1.1893116,1,108.5074,109,109.96389,110
9.806621,10,83.21269,84,94.74376,94
22.274166,22,132.97049,133,154.39801,155
15.793276,16,179.75958,180,196.97475,196
29.907242,30,187.89658,188,218.57945,218
33.638905,34,169.78317,169,203.64252,203
32.39458,33,184.50543,184,216.27892,217
27.15629,28,281.91443,282,309.42792,310
33.093945,33,561.00757,575,605.0629,608
45.522785,45,516.67914,514,560.45526,559
11.594708,12,342.35797,344,355.66232,356
11.265359,12,211.5921,211,222.16853,223
9.025246,9,177.96707,178,187.79056,187
14.322225,15,119.94211,120,135.18356,135
6.0118675,6,77.35394,78,84.748795,84
3.8793476,4,20.000025,20,24.062769,24
2.7627976,2,9.949781,10,12.034492,12
0.0010849719,0,2.0058706,1,1.1544889,1
0.0010849719,0,5.000111,5,4.7850647,5
0.0010849719,0,6.000832,6,6.005235,6
0.0010849719,0,39.008095,39,39.745953,39
3.9203622,4,141.92484,142,147.25044,146
9.33465,10,405.29822,405,417.76712,415
27.148336,27,651.2792,664,688.37415,691
22.223251,22,309.80402,310,333.7513,332
18.093054,18,153.10925,153,170.98172,171
25.389828,25,125.9852,126,151.81181,151
40.11612,40,199.47546,200,239.97765,240
32.05922,32,182.60208,182,214.17908,214
19.994596,20,160.95218,161,181.6505,181
32.25745,32,228.4347,228,259.9748,260
30.784994,31,294.34515,290,319.6156,321
19.017504,19,561.00757,564,584.3768,583
23.5147,24,542.7848,543,566.3018,567
27.459904,28,364.6269,368,398.3343,396
14.303884,15,252.23874,252,265.38385,267
4.5588293,5,207.69138,208,213.78938,213
5.5186563,6,168.37979,167,172.83987,173
9.634479,9,77.45923,78,87.425285,87
0.9351773,1,33.00164,33,33.574963,34
1.981478,2,14.000016,14,15.990001,16
0.0010849719,0,6.999994,7,6.9971147,7
0.0010849719,0,2.0058706,2,2.00761,2
0.0010849719,0,5.000111,5,4.9992633,5
3.0103538,3,33.88582,34,37.033665,37
0.98293287,1,146.37585,146,147.14816,147
6.8833165,7,405.29822,403,410.77136,410
20.963211,21,627.4626,625,644.31024,646
16.973871,17,305.07196,306,323.80774,323
10.842864,11,141.92484,142,152.71347,153
27.796963,28,139.09589,138,165.64462,166
29.110907,29,184.37161,184,213.97449,213
19.940754,20,197.74484,197,216.26491,217
27.210056,27,174.28784,174,202.67331,201
25.929073,26,191.50879,191,216.25389,217
24.021921,24,318.52173,318,342.01462,342
22.228512,22,543.0164,541,558.6326,563
10.010144,10,568.4076,563,565.4577,573
10.7105465,11,372.82074,375,386.8995,386
22.534239,23,262.3302,262,285.3504,285
19.823565,20,202.94287,204,224.5364,224
9.497892,10,142.98608,143,153.02489,153
7.071331,7,119.16171,118,124.27588,125
7.032254,7,58.178192,58,64.71349,65
4.975001,5,15.99977,16,21.020502,21
0.0010849719,0,8.999781,9,8.998691,9
0.0010849719,0,6.000832,6,6.000929,6
0.0010849719,0,5.000111,5,4.997813,5
1.991601,2,33.88582,34,36.015617,36
3.9965866,4,125.9852,126,129.12775,130
5.057998,5,361.5692,362,370.64764,367
17.14157,17,702.04156,694,716.9308,711
21.007206,21,330.24866,330,352.69016,351
33.22376,33,164.95053,165,197.08362,198
33.10867,33,184.35556,185,218.0042,218
27.700779,28,262.3617,262,290.33456,290
50.374016,52,225.77347,226,277.73447,278
47.08434,47,202.94287,204,251.3862,251
29.956375,30,238.46332,237,265.88712,267
32.95395,33,350.4203,350,382.1571,383
40.92461,41,542.7848,539,582.5059,580
22.275934,22,477.85126,483,509.84152,505
25.912169,26,305.7057,306,333.91156,332
19.883026,20,207.69223,207,227.76584,227
20.59557,21,158.77628,157,178.83943,178
23.235424,23,139.09589,139,162.75974,162
13.3457775,14,113.79268,114,128.32156,128
10.319434,11,95.00743,95,106.36636,106
12.368991,13,72.30766,74,87.28221,87
8.5625515,8,41.008904,41,48.97003,49
2.0014207,2,18.999485,19,21.001225,21
1.0005198,1,6.000832,6,6.9966283,7
1.001469,1,9.949781,10,10.9994,11
0.0010849719,0,21.000208,21,21.000784,21
7.6646748,8,69.99487,70,77.99964,78
29.891779,30,139.09589,138,167.61075,168
49.595493,48,199.47128,200,248.66066,248
61.048527,62,258.02435,258,319.9628,320
79.04465,80,342.3376,343,425.69012,423
118.31302,117,361.5692,359,476.43295,476
179.51735,179,350.2437,346,524.0718,525
170.11922,175,382.5818,380,558.8016,555
171.12753,175,373.49036,374,543.6542,549
144.19176,144,328.2837,325,468.11526,469
100.56293,101,305.7057,302,403.67685,403
33.73951,34,238.75888,237,271.69797,271
44.53815,45,207.73245,208,252.26642,253
29.323076,30,141.92484,142,171.93092,172
15.041397,15,124.32651,124,138.52293,139
15.034118,15,129.93625,130,143.85141,145
18.975094,19,113.79268,114,132.74792,133
10.477512,11,119.16171,118,129.52599,129
13.308101,14,81.014755,81,94.47586,95
7.8749437,8,64.06528,65,72.36684,73
8.861643,9,37.36843,37,45.9995,46
3.9896164,4,8.000006,8,11.998021,12
4.9384327,5,6.999994,7,12.003038,12
1.9965591,2,13.000438,13,14.998735,15
2.9457655,3,39.008095,39,42.00012,42
19.273088,19,98.71103,100,119.4274,119
52.150433,49,154.90652,155,203.44235,204
77.48305,79,250.05676,250,330.3738,329
90.918976,92,269.50348,267,361.33823,359
99.71146,101,341.95758,341,442.45343,442
111.96836,113,339.06012,334,448.0112,447
124.09515,125,304.83136,303,426.09863,428
86.56573,89,319.05432,318,410.13345,407
60.334927,59,316.8097,313,369.28452,372
48.851852,48,232.137,232,280.6465,280
35.22281,36,240.80417,240,276.57162,276
15.338979,16,193.30856,194,208.93575,210
8.850416,9,119.94211,120,129.34589,129
16.6143,17,92.99138,93,109.84963,110
7.829183,8,66.000595,66,74.04384,74
6.0081534,6,52.774178,53,59.246593,59
4.906782,5,21.999279,22,26.980694,27
0.10108346,0,18.999485,19,18.989893,19
0.0010849719,0,5.000111,5,4.9991107,5
0.0010849719,0,2.0058706,2,2.003814,2
0.99990594,1,11.000018,11,11.995004,12
0.99990594,1,37.693848,38,39.29628,39
3.029803,3,128.89658,128,129.66011,131
5.011459,5,382.79144,381,386.9419,386
13.000333,13,636.7894,650,663.0094,663
18.090118,18,260.14825,260,275.803,278
32.92714,33,105.85289,106,137.93402,139
33.23525,33,163.55579,164,197.0559,197
35.26852,35,207.77951,207,243.59741,242
45.798912,46,207.08112,205,252.08162,251
46.465343,47,169.85623,170,216.2666,217
43.066204,44,213.42828,213,257.42795,257
53.520985,55,327.59973,325,378.26587,380
33.019276,33,568.4076,586,626.9612,619
20.484077,21,568.4076,559,584.3761,580
24.857534,25,382.6117,381,402.80923,406
6.880035,7,251.88794,252,260.38364,259
14.962252,15,187.89658,188,203.91841,203
6.8941355,7,105.85289,106,113.11346,113
2.1181188,2,71.63789,72,74.07012,74
2.956539,3,26.000011,26,28.997149,29
2.9884813,3,9.949781,10,12.982431,13
0.0010849719,0,5.000111,5,4.9985633,5
0.0010849719,0,2.0058706,2,1.9995646,2
0.0010849719,0,6.000832,6,6.0100784,6
2.0027173,2,32.00482,32,33.313072,34
2.0258744,2,146.74048,146,147.9117,148
6.8844533,7,415.86176,411,420.03302,418
15.894702,16,635.38776,649,668.11127,665
27.74344,28,295.43286,298,326.82986,326
32.21014,32,144.48651,144,176.46849,176
45.57064,45,159.69379,160,205.57672,205
69.53408,70,242.58575,243,311.98096,313
49.709652,49,218.94495,218,266.05637,267
45.94727,47,177.96707,177,224.5955,224
60.218945,61,225.814,226,288.31738,287
58.961708,60,339.02954,335,392.11633,395
35.650814,37,543.0164,553,596.05914,590
15.103477,16,542.7848,534,544.2645,550
22.833393,23,361.5692,361,381.3538,384
11.037431,11,225.41547,224,235.35562,235
14.017474,14,142.98608,143,156.42502,157
7.510631,7,113.79268,115,121.55541,122
0.86518496,1,82.04646,82,82.427864,83
1.0046451,1,24.999298,25,25.986671,26
1.0017836,1,13.000438,13,14.006899,14
2.0014439,2,6.000832,6,8.004053,8
0.0010849719,0,2.0058706,2,2.0043316,2
0.0010849719,0,9.949781,10,10.003955,10
0.99990594,1,28.000011,28,28.999578,29
1.9986084,2,98.71103,99,101.84996,101
10.481498,11,262.7785,262,271.80066,273
11.945073,12,542.7848,539,545.265,551
45.44877,45,318.39093,320,364.74603,365
22.175657,22,150.91327,150,172.95407,172
42.264126,43,197.84482,198,239.85579,241
73.01902,74,270.94012,270,342.2925,344
69.303665,70,295.97913,295,365.11984,365
80.481384,84,330.69965,329,414.32913,413
66.13651,68,382.58765,381,446.45297,449
56.80586,59,415.76166,410,467.3904,469
41.087994,41,330.42047,333,374.7141,374
23.934923,24,285.82745,287,311.95053,311
23.165098,23,220.3057,220,243.05357,243
10.759946,11,124.19707,125,135.42943,136
7.710579,8,97.26076,97,104.81381,105
5.995688,6,82.04646,82,87.20557,88
6.8446417,7,49.047737,50,57.269146,57
3.137968,3,42.148315,43,45.997257,46
4.7639103,5,37.882378,37,42.00581,42
3.022598,3,14.99977,15,18.097313,18
0.0010849719,0,6.000832,6,6.003531,6
0.99990594,1,2.0058706,2,2.9971673,3
2.0099146,2,6.000832,6,8.005589,8
2.095377,2,14.99977,15,16.98239,17
6.9053226,7,49.047737,49,55.901016,56
20.047771,20,76.74536,77,96.464615,97
29.94345,25,94.00986,94,119.66635,119
63.33225,65,153.71628,154,218.68971,219
88.04871,89,142.98608,143,231.65651,232
119.21467,117,144.76413,145,262.46243,262
119.38182,125,144.73352,144,268.43472,269
119.14882,125,95.00743,95,220.93088,220
130.51796,132,96.050385,96,227.90019,228
96.97144,101,81.014755,81,181.61572,182
60.954063,66,42.27617,43,108.32451,109
17.82802,16,54.11769,54,69.25955,70
12.807671,13,30.981615,31,43.80312,44
14.793972,15,37.881516,37,52.027645,52
7.300141,7,39.008095,39,46.110237,46
7.7285147,8,35.879128,36,43.854202,44
8.016907,8,28.000011,28,35.98031,36
0.5010851,0,32.00482,32,32.07928,32
2.0277336,2,11.000018,11,12.986217,13
0.99990594,1,3.9989676,4,5.0027423,5
0.99990594,1,2.0058706,0,1.0015726,1
0.99990594,1,2.9569173,3,4.0045395,4
0.0010849719,0,9.949781,10,9.993514,10
0.25108498,0,20.000025,20,20.00106,20
4.962581,5,71.235535,72,77.97945,77
10.928132,11,83.54788,83,94.54861,94
32.350224,32,79.6839,80,111.1113,112
85.89917,87,113.79268,114,202.15413,201
118.32288,121,129.93625,130,252.33354,251
180.25664,186,193.29855,193,378.283,379
214.76184,224,199.86694,200,425.06555,424
236.1493,240,197.55484,195,433.5709,435
226.14369,233,213.1976,214,446.94336,447
153.18848,158,199.65503,199,355.76086,357
117.4682,117,182.43265,183,299.90103,300
50.168186,50,158.77628,158,207.12491,208
33.249714,33,121.76976,121,154.07333,154
41.7053,42,98.71103,100,142.00044,142
23.066612,23,75.021866,75,98.131294,98
15.8772745,16,61.784554,63,79.12354,79
19.55528,20,47.890884,47,66.88099,67
8.842949,9,33.00164,33,41.995827,42
1.8074186,1,18.999485,19,20.012802,20
9.441522,10,21.999279,22,32.151608,32
5.98078,6,5.000111,5,11.045893,11
1.0017382,1,2.0058706,2,2.993896,3
1.0027874,1,2.0058706,2,2.9925747,3
0.9453335,1,8.999781,9,10.048926,10
3.9549897,4,21.000208,21,25.032255,25
6.790117,7,54.913345,55,62.004353,62
25.620941,26,96.050385,96,121.316154,122
46.003765,46,96.050385,96,142.4443,142
54.900436,55,131.496,131,185.06265,186
52.731106,53,146.20364,146,199.13713,199
64.10241,64,160.95218,161,224.01128,225
55.88249,58,150.36584,149,207.39789,207
57.385876,59,139.09589,139,197.30528,198
41.756985,43,128.89658,127,169.66191,170
29.472706,29,97.51337,97,126.96283,126
22.317106,22,122.9754,123,144.8311,145
9.455141,9,71.855515,74,82.81974,83
2.9947174,3,54.279686,55,57.35993,58
9.098118,9,66.00278,66,75.07276,75
6.9450765,7,69.01419,69,75.1614,76
9.036959,9,47.39389,48,57.80478,57
2.9976673,3,30.981615,31,33.52753,34
4.0160174,4,32.00482,32,36.002182,36
1.069166,1,26.999556,27,28.078138,28
0.0010849719,0,8.000006,8,8.0052595,8
0.998986,1,2.0058706,1,2.0129762,2
0.0010849719,0,2.9569173,3,2.9979246,3
0.93290985,1,9.949781,10,10.981166,11
2.1419697,2,18.999485,19,20.988953,21
1.993389,2,32.00482,32,33.469486,34
12.246044,13,83.44649,83,96.66558,96
14.958725,15,124.63211,124,138.13611,139
48.217922,49,154.90652,155,203.77718,204
37.28092,37,164.95053,165,202.32635,202
37.254017,37,158.77628,158,194.63882,195
33.56463,33,169.84961,170,204.1817,203
36.54767,36,209.19672,209,246.23961,245
25.391535,25,203.02353,203,227.84276,228
10.795034,11,169.83264,170,181.37367,181
9.348444,9,131.44397,132,140.31926,141
12.83571,13,113.79268,114,126.52523,127
9.061971,9,110.003265,110,119.57662,119
3.9944074,4,60.071472,60,64.1262,64
2.99218,3,58.17919,59,62.243042,62
1.0101393,1,39.008095,40,40.993782,41
4.1704574,4,18.999485,19,22.981535,23
1.0016999,1,8.999781,9,9.989692,10
0.0010849719,0,5.000111,5,4.9955077,5
0.99990594,1,3.9989676,4,4.9966235,5
0.0010849719,0,9.949781,10,9.997077,10
0.0010849719,0,41.008904,41,40.94674,41
1.0136836,1,122.97542,123,125.04289,124
2.1238973,2,364.1554,363,365.5355,365
9.278234,9,625.6545,629,650.9395,638
9.963941,10,275.68213,276,284.76993,286
19.903158,20,128.89658,127,146.96815,147
17.848667,18,112.49133,112,129.47968,130
22.03742,22,187.89658,188,209.07161,210
19.999464,20,197.84418,197,216.40706,217
50.071274,51,177.96707,177,228.15686,228
49.50147,49,180.80566,181,231.29488,230
49.205814,49,295.6344,297,348.14545,346
12.842556,13,542.7848,540,560.74176,553
19.233269,19,502.3512,502,523.41565,521
16.047747,16,352.8587,355,371.5322,371
11.526876,12,269.68793,265,276.84344,277
8.931084,9,171.68695,172,181.53403,181
3.02794,3,101.003174,101,103.47398,104
7.767733,8,57.01625,57,64.7399,65
2.1343336,2,24.000193,24,25.977144,26
0.10108346,0,6.000832,6,6.0025654,6
0.0010849719,0,5.000111,5,5.000223,5
0.99990594,1,2.9569173,3,4.009893,4
0.0010849719,0,5.000111,5,4.9983234,5
0.0010849719,0,30.981615,31,30.973398,31
3.0271676,3,97.207535,97,99.093094,100
4.7492085,4,286.64978,289,293.68457,293
6.234034,6,489.33282,494,498.0589,500
10.425439,11,257.6745,257,268.38336,268
5.3823123,5,52.001465,52,57.61138,57
5.8937654,6,58.269196,59,64.79483,65
5.9512796,6,69.99487,70,75.255005,76
4.5260406,4,72.30766,73,78.055786,77
7.9424825,8,85.008224,86,94.69602,94
9.004498,9,146.57022,146,154.25974,155
5.0973806,5,251.92712,252,257.20255,257
12.751308,13,515.62915,514,521.63715,527
12.601799,13,464.83636,469,485.42004,482
11.625641,12,339.3629,338,352.46237,350
4.198715,4,228.60318,228,231.06902,232
6.198215,6,179.83176,179,184.73749,185
2.299974,2,95.00743,95,96.85651,97
3.264206,3,64.130875,64,66.04958,67
1.2149394,1,21.999279,22,22.996418,23
0.10108346,0,11.998885,12,12.003635,12
0.0010849719,0,2.0058706,1,1.1497846,1
0.0010849719,0,2.9569173,3,2.7892857,3
0.0010849719,0,3.9989676,4,4.0149584,4
0.0010849719,0,39.008095,39,39.31158,39
4.1214676,4,131.5326,132,135.38647,136
6.7125015,6,405.29822,403,411.44647,409
9.341233,9,662.28766,683,686.4016,692
12.485356,13,310.00366,309,323.28165,322
16.836462,17,144.8916,144,160.84038,161
19.044172,19,128.89658,127,146.90675,146
19.1857,19,189.91986,189,206.78418,208
20.863134,21,193.64386,193,213.57808,214
14.978554,15,160.95218,161,176.40594,176
7.2677517,7,171.20044,172,178.72868,179
9.006393,9,316.85168,316,322.50046,325
16.957718,17,542.7848,546,558.57526,563
12.077864,12,515.3975,530,543.0576,542
8.909384,9,382.6117,378,387.90994,387
4.999354,5,257.79016,258,262.7882,263
4.1378,4,218.74698,219,222.03621,223
6.1571717,6,150.36584,148,154.34825,154
5.1224914,5,72.30766,73,77.87842,78
4.168717,4,24.999298,25,29.005909,29
1.0078098,1,14.99977,15,16.012056,16
0.99986553,1,6.000832,6,6.997225,7
0.0010849719,0,6.999994,7,6.99695,7
0.0010849719,0,42.16078,42,42.0418,42
0.97461826,1,119.94211,120,121.555954,121
7.92552,8,352.42554,354,361.14722,362
15.0357685,15,653.57916,664,689.6586,679
12.704611,13,286.88116,286,300.33896,299
25.240194,25,153.77814,153,179.04404,178
12.98655,13,150.81512,150,162.65796,163
11.041133,11,225.67136,225,235.22028,236
14.761043,15,209.52307,209,223.8661,224
12.953304,13,174.45438,174,187.60483,187
18.890762,19,201.5238,201,220.45212,220
23.368444,24,350.4203,346,369.59015,370
16.863577,17,542.7848,544,557.79034,561
17.16207,17,516.1975,520,534.957,537
17.684914,18,328.0022,326,342.14944,344
10.559195,11,240.40115,241,252.24242,252
7.2002335,7,201.27185,201,207.40176,208
4.2484746,4,146.40002,147,151.35355,151
6.024022,6,124.18329,124,129.76543,130
3.890883,4,47.283333,48,51.989616,52
1.9910717,2,17.000002,17,19.00583,19
1.9863206,2,9.949781,10,11.995636,12
0.0010849719,0,3.9989676,4,4.0011,4
0.0010849719,0,2.9569173,3,2.994206,3
0.99990594,1,39.008095,39,39.806725,40
1.9701984,2,103.992905,104,106.657196,106
5.992923,6,350.22388,346,352.4912,352
19.767189,20,696.11896,709,715.11694,729
16.601068,17,316.87268,313,329.483,330
9.974853,10,159.69379,159,170.01453,169
30.61622,31,169.91147,170,201.75612,201
25.137146,25,242.28162,243,268.65543,268
21.027582,21,240.13983,241,262.44965,262
26.134434,26,225.72699,225,252.25423,251
34.005253,34,261.9837,262,296.30746,296
36.911037,37,364.1759,368,403.83563,405
30.462992,31,542.7848,551,582.01306,582
20.097597,20,489.62976,489,510.67175,509
18.09237,18,361.5692,359,378.27676,377
11.57895,12,231.71567,233,245.38594,245
13.61432,14,169.72058,169,184.00716,183
18.120672,18,144.58557,145,162.36673,163
10.2415085,11,98.71103,99,109.864044,110
8.635177,9,98.71103,99,108.68986,108
5.743251,5,64.40413,64,69.17067,69
3.6530592,3,47.667755,47,50.47149,50
0.9937094,1,14.000016,14,14.986079,15
0.0010849719,0,5.000111,5,4.9955087,5
0.9933265,1,11.998885,12,12.983797,13
6.802787,7,20.000025,20,26.988865,27
7.706118,7,55.987305,56,62.513527,63
10.331969,11,132.96747,133,144.76883,144
33.27748,34,159.78455,159,192.2243,193
45.774464,45,211.14267,211,257.30524,256
71.653,74,318.99353,318,392.77927,392
115.433174,119,328.21228,327,446.6821,446
120.897316,123,386.37476,386,508.0779,509
113.33568,110,372.88184,369,473.59412,479
115.13415,113,373.50403,371,485.06934,484
89.14479,89,352.7802,354,438.76962,443
47.92277,50,269.55054,270,319.63058,320
41.942204,42,257.60693,255,296.55585,297
29.936838,30,218.67316,219,248.83353,249
27.60133,28,169.65775,170,197.52605,198
22.386972,23,134.63638,135,158.88893,158
16.493362,17,129.93625,130,147.00311,147
9.3365555,10,116.00862,116,126.17842,126
8.705143,9,108.666336,108,116.09442,117
9.284007,10,83.629135,84,94.46332,94
2.0185845,2,71.3053,72,73.996956,74
3.983166,4,21.000208,21,25.013945,25
0.9912627,1,6.000832,6,7.00083,7
0.99058825,1,6.999994,7,8.001522,8
0.9689546,1,14.99977,15,16.005983,16
5.5737615,5,26.000011,26,30.95213,31
11.765896,12,81.014755,81,93.18401,93
36.496872,37,134.35587,135,173.01021,172
61.479015,63,230.24149,230,294.3764,293
80.55752,81,272.67212,274,356.7628,355
109.01658,111,415.95337,409,521.7917,520
84.02982,84,350.4203,347,434.02972,431
140.23645,142,330.22638,331,477.44995,473
106.98394,106,309.09888,311,413.62784,417
89.586914,85,361.5692,358,440.06198,443
57.331818,59,247.05634,244,303.06104,303
24.87899,25,177.96707,178,204.02168,203
15.90921,16,158.77628,158,174.90057,174
11.485907,12,141.92484,142,154.44241,154
8.423601,8,91.07919,91,99.263504,99
11.00523,11,85.008224,85,96.77402,96
6.908603,7,44.00444,44,50.028008,51
2.9011724,3,18.000223,18,20.999826,21
1.974473,2,11.000018,11,12.971907,13
0.99990594,1,8.999781,9,9.978152,10
2.0094547,2,6.000832,6,8.00421,8
0.99990594,1,3.9989676,4,5.0009694,5
0.0010849719,0,37.75187,38,38.00089,38
1.9586482,2,135.983,136,138.76807,138
9.054001,9,385.9983,387,396.95743,396
19.207817,19,693.92755,712,714.3075,731
19.17377,19,286.65637,289,308.6014,308
30.519571,31,105.036316,105,135.1304,136
48.78001,51,182.77078,182,233.27536,233
39.968445,40,228.08539,228,268.60315,268
79.258804,81,240.41376,240,319.59628,321
48.489384,51,209.5816,209,259.90613,260
55.943115,58,209.52203,210,268.22845,268
44.66866,45,395.64807,397,439.90594,442
43.109562,43,670.338,665,713.3733,708
25.942211,26,669.5185,666,692.78845,692
27.101276,27,442.19623,444,468.25443,471
16.007277,16,283.7276,284,300.03662,300
13.702124,14,207.63583,207,220.35657,221
5.025859,5,139.09589,139,144.85567,144
9.054246,9,92.99138,93,101.969734,102
6.1974688,6,49.047737,49,54.994022,55
3.0077908,3,21.999279,22,25.297518,25
2.9721298,3,5.000111,5,8.004405,8
0.99990594,1,2.9569173,3,3.9998055,4
0.0010849719,0,6.999994,7,6.9991746,7
0.99990594,1,44.994705,45,46.059982,46
2.9902694,3,150.92007,150,152.94267,153
6.796209,7,489.37927,495,507.17096,502
20.877548,21,701.9224,700,711.49384,721
19.215277,19,316.4342,317,337.3847,336
25.812477,26,129.93625,130,156.39258,156
23.820215,24,182.57043,183,207.32265,207
39.69097,39,272.69403,273,312.12546,312
39.573597,39,232.08237,233,271.4251,272
39.62223,39,230.48483,231,269.74033,270
53.523018,56,246.86343,244,300.02707,300
43.340206,44,386.38507,391,434.6283,435
43.688564,43,699.7874,700,746.557,743
37.189243,38,693.9874,693,709.3142,731
45.357338,46,416.07977,414,462.4093,460
34.056416,34,272.70575,272,306.96307,306
26.914448,28,251.65793,252,280.87625,280
25.942194,26,154.90652,155,181.32387,181
5.092929,5,91.07919,91,96.91208,96
6.29326,6,30.981615,31,37.002926,37
0.10108346,0,11.000018,11,11.088629,11
2.000861,2,6.999994,7,8.986723,9
0.0010849719,0,6.999994,7,6.9876285,7
0.99990594,1,8.999781,9,9.978171,10
0.99990594,1,47.517548,48,48.987892,49
4.8619437,5,119.16171,119,124.29334,124
9.3501835,9,387.13257,389,397.6065,398
22.143333,22,729.7037,737,748.27136,759
25.768812,26,361.6206,362,388.60706,388
13.659676,14,128.89658,127,140.4481,141
10.785444,11,160.95218,161,172.0718,172
24.296564,24,207.68701,208,231.4195,232
14.209143,14,199.34921,200,214.38507,214
39.681587,39,179.59702,179,218.46223,218
20.45871,20,268.72345,265,284.99707,285
23.05486,23,353.0691,354,377.76654,377
29.545761,29,568.4076,576,609.4785,605
29.171183,29,568.4076,580,610.4614,609
13.836479,14,404.7118,400,414.14404,414
19.347317,19,272.75873,274,294.22433,293
13.444053,14,184.6441,184,196.19363,198
4.107441,4,101.003174,101,104.67227,105
5.0252147,5,69.01419,69,73.99452,74
0.91151947,1,42.235466,43,43.002747,44
0.10108346,0,15.99977,16,16.033758,16
0.0010849719,0,8.999781,9,9.026773,9
0.0010849719,0,2.0058706,2,1.9480672,2
0.99250126,1,8.000006,8,8.971631,9
0.0010849719,0,32.00482,32,32.027725,32
2.0827758,2,121.61275,122,124.18888,124
7.971108,8,383.54602,381,386.6777,389
12.676629,13,621.25146,646,665.7019,659
18.966562,19,257.79254,257,277.66434,276
24.74974,23,121.82881,122,144.75783,145
15.836105,16,161.98389,162,178.68257,178
29.101734,29,207.08112,206,235.62663,235
32.92089,33,211.61111,212,245.77922,245
37.00373,37,174.71768,175,211.19861,212
37.932777,38,232.05847,232,268.7208,270
39.171684,39,293.87805,292,330.35892,331
30.757458,31,561.3942,586,611.942,617
23.149435,23,542.7848,542,564.4563,565
12.564798,13,361.74878,360,374.0047,373
5.0184817,5,221.98065,222,228.01888,227
7.085283,7,184.21548,184,190.29037,191
2.0467095,2,131.52109,131,132.50227,133
0.35108346,0,92.99138,93,92.995735,93
3.1492348,3,44.994705,45,47.032536,48
1.986803,2,26.000011,26,28.009598,28
0.0010849719,0,11.000018,11,11.003973,11
0.0010849719,0,5.000111,5,4.7890124,5
0.0010849719,0,9.949781,10,9.995077,10
0.99990594,1,24.999298,25,25.990353,26
0.25108498,0,83.48877,84,84.94153,84
2.9805527,3,211.17847,212,214.2196,215
10.697928,11,432.04572,430,441.10486,441
10.010766,10,293.5354,291,298.94214,301
16.009962,16,150.91171,150,165.51599,166
20.142986,20,182.48355,183,203.47,203
36.196033,36,202.93362,204,239.79147,240
23.005339,23,197.93484,197,220.39604,220
40.10793,40,174.59445,175,214.41121,215
34.09679,34,269.96973,269,302.52597,303
39.341713,39,339.1665,336,374.1462,375
29.260326,29,542.7848,539,567.5753,568
25.291908,25,477.5298,473,495.63895,498
14.983329,15,339.1665,337,353.31467,352
11.286965,12,228.23853,229,239.9383,241
9.50014,9,161.98389,162,170.78378,171
14.5468645,15,150.92007,150,165.39368,165
6.118326,6,116.00862,116,121.55773,122
4.9825788,5,97.43787,98,103.436264,103
15.966411,16,83.62256,84,99.214165,100
3.7177296,3,67.104126,67,69.24142,70
5.9984546,6,23.000067,23,29.012316,29
2.9872878,3,8.999781,9,12.002416,12
2.002694,2,3.9989676,4,5.9966474,6
0.95890594,1,18.999485,19,19.979364,20
3.110839,3,35.879128,36,39.541336,39
4.842795,5,105.85289,106,111.17368,111
17.2932,17,153.52792,153,169.65141,170
43.16984,43,246.83575,244,288.012,287
60.002346,63,342.3177,341,403.22293,404
116.53326,122,364.3214,364,484.78113,486
148.19444,148,405.70667,399,543.7227,547
159.88266,164,382.9359,378,544.5933,542
162.31999,167,373.51416,374,544.6127,541
136.89684,139,364.55194,368,508.01584,507
72.59683,77,269.7705,268,347.8141,345
40.23492,40,262.19873,264,302.70187,304
34.088554,34,211.36078,212,245.72917,246
20.752295,20,161.98389,162,181.59727,182
33.648,34,174.5593,175,209.20844,209
23.223753,23,139.09589,137,160.70096,160
17.561441,18,144.4931,144,162.62099,162
13.628348,15,102.120926,103,118.096146,118
17.266232,17,85.008224,85,101.665276,102
8.419415,8,69.99487,70,77.34713,78
13.085609,14,33.88582,34,47.093353,48
1.0048665,1,11.000018,11,11.988576,12
0.0010849719,0,8.000006,8,8.007648,8
0.0010849719,0,6.000832,6,5.9555216,6
0.9115609,1,21.999279,22,22.947233,23
0.79246664,1,67.104126,68,69.26903,69
11.284955,9,94.00986,94,103.495316,103
39.31431,39,179.83728,180,218.67856,219
40.087124,40,209.26666,210,249.47781,250
56.375866,60,257.3495,255,315.41315,315
60.64553,65,220.26758,220,285.31262,285
45.317,42,189.83353,190,231.17653,232
25.099323,25,199.64145,200,224.40353,225
32.53509,33,220.28537,220,251.00616,253
19.846237,20,209.78122,209,228.89342,229
16.467451,17,180.90216,181,197.88791,198
11.314544,12,110.003265,110,121.5036,122
6.0357194,6,102.075516,102,108.644615,108
9.492247,10,85.008224,86,96.54897,96
3.05868,3,75.93294,75,77.39854,78
3.005331,3,47.35093,48,50.12918,51
0.4010845,0,20.000025,20,19.967852,20
0.10108346,0,3.9989676,4,4.004274,4
2.0099888,2,2.9569173,3,4.996544,5
0.0010849719,0,3.9989676,4,4.0085583,4
2.994794,3,8.999781,9,11.99683,12
0.0010849719,0,26.999556,27,27.011003,27
2.046723,2,121.59361,121,122.73423,123
3.051398,3,293.667,291,293.73825,294
9.235922,9,568.4076,575,582.5132,584
10.922512,11,273.22797,273,285.14206,284
11.7873745,12,121.80087,121,132.9478,133
7.653207,8,125.9852,126,134.35857,134
22.523722,23,150.93875,150,172.82475,173
29.183123,30,189.80923,190,220.55475,220
30.25555,31,179.8677,179,208.97786,210
29.052103,29,207.76495,207,235.2892,236
36.90487,37,309.28815,308,347.50897,345
36.60234,38,568.4076,578,608.0761,616
19.909914,20,542.65436,544,564.38947,564
17.915787,18,416.4535,409,425.07196,427
12.9476,13,286.4182,287,299.39117,300
20.547794,21,225.53549,224,245.974,245
10.655428,11,113.79268,115,126.62768,126
7.9239235,8,75.684784,76,84.61258,84
2.45776,2,28.999556,29,30.974789,31
1.7408025,1,6.999994,7,8.010435,8
0.0010849719,0,2.0058706,1,1.2063338,1
0.0010849719,0,2.9569173,3,2.9993749,3
0.0010849719,0,8.000006,8,8.010865,8
0.99990594,1,39.008095,40,40.92473,41
0.25108498,0,119.16171,118,118.276695,118
8.122942,8,374.57056,372,377.5902,380
16.071344,16,692.7244,708,711.9414,724
11.982625,12,319.12482,322,333.87506,334
11.987398,12,141.92484,142,154.4667,154
28.008516,28,144.60614,145,172.20393,173
12.768363,13,213.5469,213,228.29106,226
27.94152,28,225.90399,226,255.0798,254
19.263716,19,184.71942,185,203.87463,204
19.971601,20,249.37518,250,268.4818,270
23.609962,24,339.2041,334,355.73563,358
20.669212,21,561.00757,580,593.5397,601
22.734823,23,516.67914,523,544.4765,546
20.55053,21,415.2849,412,433.85727,433
8.875918,9,249.7002,248,257.72083,257
13.2794895,14,193.43958,193,207.16795,207
6.0566034,6,98.71103,100,106.45183,106
3.96058,4,60.071472,60,63.96506,64
0.9628856,1,33.00164,33,33.16451,34
2.975738,3,18.000223,18,21.0068,21
4.932465,5,3.9989676,4,8.983285,9
3.0094604,3,6.999994,7,9.975108,10
0.0010849719,0,3.9989676,4,4.006613,4
0.0010849719,0,37.478584,37,37.0059,37
2.0518641,2,125.9852,126,128.30026,128
2.8079946,3,364.16138,366,369.59457,369
18.032108,18,662.3877,670,686.56836,688
12.840485,13,273.4615,272,284.85974,285
20.00074,20,116.00862,116,135.2168,136
23.683205,24,150.36584,148,172.04039,172
13.83226,14,218.61612,218,231.26685,232
17.816278,18,220.58194,220,237.28334,238
34.07494,34,191.12653,191,224.52715,225
20.861734,21,207.5812,207,228.30727,228
19.052296,19,309.66064,310,329.16302,329
20.966969,21,543.0164,540,557.0931,561
25.458035,25,515.62915,515,543.7443,540
17.663702,18,387.17664,384,403.00052,402
24.588789,25,242.10938,243,268.27393,268
15.370316,16,187.89658,186,202.08453,202
3.9855316,4,119.16171,118,121.23401,122
2.9972444,3,75.630936,76,79.10451,79
0.9498832,1,30.981615,31,31.980091,32
3.9877899,4,18.999485,19,23.012243,23
3.0179527,3,5.000111,5,7.993068,8
0.0010849719,0,2.0058706,2,1.7996719,2
0.0010849719,0,8.000006,8,8.004759,8
2.013951,2,30.981615,31,33.09921,33
2.0438344,2,112.38382,112,114.47958,114
4.8679056,5,383.80774,380,387.85242,385
23.60908,24,623.55145,655,689.7623,679
24.788122,25,304.42175,300,324.51242,325
27.503252,28,139.09589,139,167.54295,167
25.18334,25,163.36624,164,188.82472,189
30.049196,30,251.90671,252,282.628,282
40.661903,41,230.61697,230,271.51068,271
30.84188,31,211.51483,211,243.38402,242
40.048935,40,240.66306,240,280.88275,280
49.21277,50,352.42554,356,403.1575,406
43.099934,43,502.3512,507,544.9218,550
20.251713,20,443.4524,446,466.2781,466
19.879293,20,328.40393,328,348.0483,348
5.8422036,6,237.06616,235,240.1391,241
12.575684,13,199.63562,200,214.76231,213
6.765968,7,140.82303,141,148.00928,148
4.92767,5,113.79268,115,119.34725,120
3.9570296,4,42.26078,43,47.064156,47
0.2010839,0,26.000011,26,25.990114,26
3.0054908,3,6.000832,6,8.995641,9
0.0010849719,0,11.998885,12,11.779571,12
0.99990594,1,8.999781,9,9.9967785,10
0.0010849719,0,33.88582,34,33.51756,34
0.96342605,1,112.540955,112,113.097916,113
2.8983116,3,305.4184,305,309.21747,308
12.996176,13,628.2794,623,627.9816,636
12.989408,13,330.1272,330,342.54938,343
27.761583,28,161.98389,162,190.23143,190
30.925919,31,179.90952,180,210.94952,211
29.314016,29,247.07861,244,271.81235,273
39.273315,39,273.4773,274,311.7283,313
46.797207,48,249.80295,251,299.85434,299
56.199326,57,251.90671,252,308.87924,309
45.305447,45,373.216,372,414.0686,417
39.975986,40,568.79425,582,626.5446,622
23.2103,23,432.98328,432,452.4922,455
17.163647,17,305.63232,302,318.5731,319
12.015906,12,209.37259,209,220.6927,221
7.480395,7,164.95053,165,172.805,172
3.9788089,4,134.18164,134,138.19022,138
10.305386,11,122.97507,123,134.00423,134
3.868304,4,90.02431,90,94.542046,94
8.86524,9,85.008224,86,94.60942,95
6.0205994,6,61.784554,63,69.01842,69
4.9317045,5,18.000223,18,23.00497,23
0.98538125,1,5.000111,5,6.004196,6
0.0010849719,0,2.9569173,3,2.989697,3
0.0010849719,0,11.000018,11,10.979254,11
0.88100415,1,47.500954,47,46.947758,48
8.174098,8,111.01523,111,119.10233,119
17.169516,17,203.04358,203,220.14015,220
22.898264,23,249.26166,250,271.2865,273
60.27126,66,328.28925,327,391.7069,393
82.97005,89,364.07135,364,453.4923,453
86.42727,88,364.3214,368,453.91534,456
89.78086,92,339.02954,334,424.76688,426
87.878456,95,352.8587,352,445.53314,447
83.37734,85,328.50317,328,414.38766,413
36.417034,35,273.6153,274,308.66626,309
40.150936,40,232.15152,232,271.0966,272
32.294857,32,225.82303,225,257.66028,257
23.255201,23,177.96707,178,202.17596,201
14.505499,15,169.81769,169,183.63075,184
21.751617,22,134.13513,134,156.73209,156
10.452517,11,108.429184,108,119.40707,119
7.8031435,8,102.18808,102,110.03183,110
13.290842,14,82.04646,82,96.237404,96
7.8461046,8,79.53549,79,87.50292,87
0.9719105,1,37.588417,37,38.092278,38
0.98446226,1,9.949781,10,11.010319,11
0.0010849719,0,8.999781,9,8.996654,9
0.0010849719,0,6.000832,6,5.847826,6
4.841505,5,21.999279,22,27.00924,27
15.940048,12,75.52907,76,87.50453,88
23.093784,19,112.18341,113,132.29172,132
46.216175,42,213.46484,215,257.14023,257
50.295925,47,249.69278,248,293.64365,295
64.684135,67,350.2437,350,411.92447,417
64.7874,67,286.81134,289,355.51648,356
47.594273,50,260.3864,260,309.18582,310
44.403076,46,293.71576,292,337.26566,338
62.027073,66,339.2434,334,398.1963,400
29.228956,29,213.64157,214,243.53033,243
7.503233,8,98.71103,99,106.38083,107
9.508203,10,98.71103,99,108.38283,109
13.4956455,14,108.36372,108,121.340324,122
14.037533,14,91.07919,92,106.71673,106
6.4852276,6,83.30888,83,89.02042,89
4.033076,4,28.999556,29,33.148865,33
2.1179323,2,26.000011,26,27.970686,28
1.0047487,1,14.000016,14,14.994629,15
0.99990594,1,3.9989676,4,5.0048637,5
0.0010849719,0,2.9569173,3,2.9945068,3
2.0089536,2,2.9569173,3,5.0013485,5
0.0010849719,0,24.000193,24,24.005999,24
0.9848989,1,105.85289,107,108.490234,108
5.0419035,5,317.11328,314,319.08063,319
10.013088,10,568.4076,582,598.9793,592
10.996309,11,272.86224,271,282.6646,282
14.794109,15,119.94211,120,135.38022,135
22.081963,22,150.36584,148,169.58385,170
20.98,21,211.37643,211,231.19458,232
16.043774,16,193.37985,194,208.72957,210
11.858357,12,169.86404,169,181.52504,181
14.407316,15,197.55484,196,210.91733,211
13.870069,15,286.3736,287,302.9344,302
16.879414,17,477.9558,478,496.80997,495
13.792026,14,489.06183,493,508.7472,507
6.9505534,7,330.05017,333,338.86636,340
8.045595,8,191.36102,192,199.65213,200
6.449701,6,113.79268,114,119.70003,120
4.947227,5,49.047737,49,53.758976,54
5.89731,6,41.008904,41,47.05277,47
0.90108484,0,18.000223,18,17.995573,18
0.10108346,0,14.99977,15,14.999263,15
1.9944234,2,5.000111,5,7.0033894,7
0.0010849719,0,5.000111,5,5.0019517,5
2.9941466,3,5.000111,5,8.003582,8
0.0010849719,0,35.879128,36,35.995144,36
0.9628097,1,119.16171,117,117.78771,118
4.0120707,4,352.8587,351,354.55774,355
10.034543,10,628.4817,652,668.78204,662
19.037617,19,304.74707,307,326.70877,326
22.200228,22,161.98389,162,183.44261,184
55.59027,58,211.49979,211,268.82834,269
48.66331,49,262.05328,264,311.58746,313
52.53439,51,236.74527,235,285.1674,286
54.44393,56,191.12653,191,245.55434,247
27.494228,28,218.57516,218,245.09816,246
40.06975,40,328.29877,323,365.52057,363
39.213753,39,543.0164,533,566.0562,572
13.074691,13,516.42914,512,526.04205,525
19.220982,19,339.039,334,352.83038,353
4.2689366,4,262.2721,264,268.39117,268
9.000519,9,159.69241,159,167.70956,168
5.019561,5,128.89658,127,132.52646,132
0.6115922,1,79.68646,80,80.78935,81
5.736425,6,35.000343,35,40.970978,41
0.99112904,1,14.000016,14,15.0146265,15
0.99990594,1,2.0058706,2,2.9977653,3
0.0010849719,0,5.000111,5,4.997224,5
0.99990594,1,6.000832,6,6.9852476,7
2.0046332,2,28.999556,29,30.97233,31
2.9804811,3,108.32945,109,111.122086,112
3.0783358,3,361.97156,360,365.11502,363
12.985193,13,653.57916,665,667.4063,678
8.09064,8,309.20038,309,315.81754,317
17.233139,17,146.71481,147,163.61464,164
30.79668,31,169.66855,169,199.53256,200
32.759514,33,202.96011,203,235.47409,236
29.769215,30,182.62692,183,213.89708,213
32.976624,33,184.53162,185,218.66035,218
27.694595,28,209.58493,209,237.15735,237
36.579044,37,296.3922,297,333.94522,334
25.737051,26,543.0164,536,559.5164,562
22.924156,23,543.0164,546,567.3416,569
7.00346,7,330.9054,329,338.09283,336
9.718702,10,229.91113,231,240.38855,241
4.0149937,4,163.27118,164,167.61668,168
11.277748,12,119.16171,117,129.31433,129
3.9474854,4,83.62256,84,87.48688,88
1.828765,2,39.008095,40,42.00091,42
0.98936385,1,18.999485,19,19.996891,20
1.9822222,2,6.000832,6,8.007677,8
0.99990594,1,2.9569173,3,4.0021744,4
0.0010849719,0,6.000832,6,6.0113873,6
0.0010849719,0,35.000343,35,34.99297,35
3.9634657,4,113.79268,114,118.0838,118
4.012931,4,350.22388,346,353.2269,350
13.960605,14,568.4076,585,593.27783,599
13.943808,14,305.19415,303,315.55865,317
23.14097,23,139.09589,138,161.0188,161
22.233536,22,168.37979,168,190.41711,190
30.967976,31,180.93832,181,211.38193,212
46.048767,46,171.22458,171,216.36748,217
43.323944,43,171.43079,171,214.00168,214
33.063942,33,217.04593,216,248.64238,249
20.977606,21,282.11902,281,302.16656,302
25.138601,25,443.69244,450,476.88498,475
22.250736,22,361.48993,359,381.92316,381
3.4019034,3,113.79268,115,118.13569,118
0.959996,1,49.047737,49,50.289467,50
0.9892596,1,24.999298,25,26.05471,26
0.98461837,1,20.000025,20,21.039862,21
0.4010845,0,13.000438,13,12.9703245,13
0.4010845,0,17.000002,17,17.002848,17
2.157291,2,6.999994,7,8.971216,9
-0.09540044,0,2.9569173,3,2.9886937,3
-0.09540044,0,2.9569173,3,2.9993272,3
0.9961064,1,5.000111,5,5.998474,6
0.0010849719,0,13.000438,13,12.993732,13
4.059428,4,75.588165,76,80.798065,80
3.0450099,3,207.08112,205,207.54393,208
8.131111,8,465.31964,464,476.6548,472
2.5422385,2,268.48663,265,266.59744,267
7.9483743,8,146.09015,146,154.37943,154
10.925071,12,150.81512,150,161.92253,162
25.02237,25,199.64737,199,224.86751,224
26.02033,26,213.54062,214,240.20355,240
22.317686,20,199.54666,199,218.27477,219
29.31634,29,236.8046,234,263.0388,263
27.982454,28,251.88214,253,280.80356,281
23.36853,24,296.18738,297,319.8665,321
7.03367,7,236.69809,236,243.69405,243
5.068597,5,150.36584,148,152.92976,153
7.859622,8,103.992905,104,111.347046,112
1.9534063,2,67.1754,68,69.7959,70
5.9288926,6,57.01625,57,62.043396,63
0.98030794,1,39.008095,39,39.139908,40
0.9202517,1,30.000034,30,30.983646,31
1.0070639,1,33.88582,34,34.93093,35
0.2010839,0,23.000067,23,23.117874,23
0.0010849719,0,6.999994,7,7.0004797,7
3.0173852,3,2.0058706,2,5.00227,5
0.0010849719,0,5.000111,5,4.6484904,5
0.0010849719,0,13.000438,13,12.64433,13
1.9626708,2,18.000223,18,20.033083,20
0.45108387,0,28.999556,29,29.058165,29
12.410393,13,77.01631,77,89.84662,90
12.408335,13,105.036316,105,118.079155,118
29.104591,29,129.93625,130,158.88867,159
17.907213,18,128.89658,128,147.1172,146
23.252094,23,134.70471,135,158.97868,158
20.529156,20,140.81403,141,160.80772,161
12.731396,14,139.09589,139,153.01463,153
22.87271,23,124.86003,124,147.28426,147
13.876915,15,98.71103,99,114.2009,114
7.50195,7,75.57263,75,82.75251,82
9.19994,9,51.022316,51,59.72876,60
5.990649,6,54.71022,55,61.005123,61
3.9900806,4,49.047737,49,53.987885,53
0.98284656,1,37.250824,38,39.468895,39
3.012627,3,37.121902,37,39.371086,40
2.9854763,3,24.000193,24,26.966633,27
1.016089,1,18.999485,19,20.092144,20
1.0017796,1,17.000002,17,18.069311,18
0.0010849719,0,8.999781,9,8.969257,9
1.0023212,1,2.9569173,3,4.0183263,4
0.0010849719,0,6.000832,6,6.0080905,6
3.909802,4,5.000111,5,8.976714,9
2.970892,3,15.99977,16,19.075314,19
5.275541,5,42.251022,43,47.002357,48
7.577693,7,49.047737,49,55.86786,56
26.235924,26,67.262695,67,93.150444,93
46.314514,48,103.992905,104,151.76996,152
46.91873,52,144.86972,144,197.62395,196
60.518204,63,122.96094,123,184.95491,186
54.15361,57,119.16171,118,175.28648,175
39.171795,39,97.71657,98,137.64262,137
50.19005,53,139.09589,137,190.08618,190
20.97649,21,92.99138,93,114.49789,114
8.13107,8,85.008224,85,93.163445,93
4.528383,4,54.2032,54,57.140125,58
0.2010839,0,52.001465,52,52.04919,52
4.0126114,4,37.76609,38,42.00914,42
4.956793,5,52.774178,53,57.25663,58
2.9912417,3,21.999279,22,25.010893,25
0.2010839,0,11.998885,12,11.994673,12
0.10108346,0,11.000018,11,11.0109625,11
0.0010849719,0,5.000111,5,4.9970317,5
0.9775076,1,2.0058706,2,2.9801028,3
0.0010849719,0,8.999781,9,9.005691,9
1.0015981,1,15.99977,16,16.987345,17
3.1343997,3,26.999556,27,29.970255,30
4.454487,4,61.784554,62,66.03024,66
16.810232,17,67.07744,68,84.508934,85
20.830343,21,82.04646,82,103.19465,103
19.474545,20,103.992905,104,124.434845,124
21.786884,22,112.17076,113,135.49634,135
15.319596,16,54.47235,54,69.49368,70
12.278616,13,33.00164,33,46.000027,46
5.9008207,6,26.999556,27,33.271362,33
5.94182,6,26.999556,27,33.35338,33
7.1784225,7,18.999485,19,26.049181,26
6.1571326,6,20.000025,20,26.003988,26
3.912716,4,14.000016,14,18.005041,18
6.051765,6,17.000002,17,22.99998,23
12.321254,13,8.999781,9,21.964901,22
6.9378047,7,5.000111,5,12.001321,12
1.0023848,1,9.949781,10,11.017874,11
3.002572,3,9.949781,10,12.9633465,13
0.10108346,0,13.000438,13,13.001064,13
0.0010849719,0,6.999994,7,6.992693,7
0.0010849719,0,2.0058706,1,1.1250038,1
1.9909573,2,2.0058706,1,2.9728575,3
1.0038422,1,6.000832,6,6.9698005,7
0.2010839,0,6.000832,6,6.006799,6
1.5067142,1,9.949781,10,11.031265,11
7.1336074,7,21.000208,21,28.02584,28
11.056634,11,21.000208,21,32.066517,32
42.73393,43,42.597115,43,85.97361,86
57.829292,62,52.001465,52,114.313194,114
72.88989,75,45.686646,46,121.374466,121
56.99199,58,67.1727,68,126.31492,126
48.840378,51,55.987305,56,106.97285,107
46.164986,48,37.683395,38,86.05171,86
15.71537,16,33.88582,34,50.839054,50
20.341042,20,23.000067,23,43.435562,43
16.04711,16,20.000025,20,36.061127,36
10.345032,11,28.999556,29,39.184258,40
7.836831,8,26.000011,26,33.1593,34
2.9873688,3,15.99977,16,19.006721,19
4.001927,4,26.000011,26,29.98441,30
0.9562319,1,8.000006,8,8.99237,9
0.10108346,0,6.999994,7,6.999693,7
0.0010849719,0,2.0058706,1,1.1253108,1
0.0010849719,0,2.0058706,2,1.9624377,2
0.0010849719,0,2.0058706,2,1.816156,2
0.0010849719,0,11.000018,11,11.003763,11
0.0010849719,0,35.879128,36,36.00241,36
0.10108346,0,26.000011,26,25.975698,26
0.92033756,0,30.981615,31,31.118343,31
1.5856588,1,21.999279,22,23.185703,23
0.6010836,0,8.000006,8,8.144366,8
0.28446972,0,9.949781,10,9.932592,10
0.4010845,0,9.949781,10,9.927709,10
0.8723717,0,14.99977,15,14.98403,15
0.90513796,0,20.000025,20,19.918816,20
0.6010836,0,13.000438,13,13.020547,13
0.6010836,0,13.000438,13,13.009923,13
2.6381357,2,51.022316,51,53.791878,53
1.6337188,1,42.08663,42,43.31966,43
2.6253347,2,33.00164,33,34.919857,35
0.2010839,0,32.00482,32,31.93242,32
0.2010839,0,20.000025,20,19.978634,20
-0.14614171,0,11.000018,11,11.022277,11
2.0216274,2,8.000006,8,9.939098,10
0.2010839,0,2.9569173,3,2.9852889,3
-0.07960057,0,5.000111,5,4.9976764,5
-0.14936627,0,2.0058706,2,1.9869127,2
0.0010849719,0,2.0058706,1,0.98187965,1
0.0010849719,0,2.9569173,3,2.9979737,3
0.9775076,1,9.949781,10,11.003427,11
-0.2749784,0,44.994705,45,45.032284,45
0.10108346,0,90.02431,90,89.871445,90
2.6846268,2,207.08112,206,207.46222,208
6.5637727,6,128.89658,127,132.36632,133
8.381979,8,67.262695,67,75.12463,75
23.173468,23,79.46036,80,103.358086,103
22.090248,22,86.99153,87,108.21527,109
19.080349,19,98.71103,99,118.073685,118
25.331232,25,94.00986,94,119.212395,119
31.022575,31,88.39128,89,119.42937,120
23.181406,23,150.81512,151,175.11285,174
30.190222,30,228.47946,227,257.20636,257
9.407414,9,187.89658,188,197.11551,197
10.9957075,11,105.85289,106,116.69695,117
11.2889805,12,79.514786,79,91.62183,91
11.277993,12,51.022316,51,62.743248,63
10.35658,11,33.00164,33,43.00032,44
1.9929955,2,24.000193,24,26.00224,26
2.9533286,3,21.999279,22,25.012148,25
0.2010839,0,8.999781,9,8.980421,9
0.0010849719,0,5.000111,5,4.9766593,5
0.0010849719,0,2.0058706,2,1.7906783,2
0.0010849719,0,3.9989676,4,3.9986825,4
0.0010849719,0,14.99977,15,14.982943,15
1.965739,2,49.047737,49,50.664486,51
0.8190997,1,111.01523,111,111.37066,112
1.6904343,1,238.69592,238,240.03581,239
17.392673,18,172.81412,173,190.33667,191
72.76651,77,85.008224,85,162.53773,162
69.88932,71,105.85289,107,178.86464,178
71.587105,72,150.81512,150,221.49939,222
75.52785,76,146.5654,146,221.60179,222
82.11308,84,177.96707,177,259.71188,261
72.47785,74,150.81512,151,224.21964,225
42.40716,42,207.74109,208,248.99503,250
43.189613,43,228.85245,228,271.30032,271
16.12548,16,197.84418,197,214.4729,213
15.045581,15,112.31712,113,128.48141,128
13.3575115,14,83.41824,83,96.83494,97
16.644875,17,75.57959,75,91.335045,92
12.272371,13,49.047737,49,62.317398,62
4.990707,5,54.38214,54,59.579243,59
0.9331322,1,24.999298,25,25.98913,26
6.0610113,6,30.981615,31,36.957058,37
0.9874459,1,18.000223,18,19.006346,19
1.002283,1,5.000111,5,6.0037484,6
0.0010849719,0,2.9569173,3,2.9961457,3
0.0010849719,0,2.9569173,3,2.9823294,3
0.0010849719,0,6.999994,7,6.9742594,7
0.99444103,1,17.000002,17,18.01253,18
8.776131,9,35.000343,35,43.218296,44
15.391853,16,33.00164,33,49.029167,49
5.9773836,6,35.000343,35,41.007164,41
6.83872,7,37.598297,38,45.04248,45
4.769648,5,42.075417,43,46.91519,48
12.326892,13,71.53665,71,84.234665,84
8.931517,10,88.652756,88,98.221176,98
18.546986,19,110.003265,110,128.98761,129
22.001938,22,124.59659,125,146.91292,147
18.052292,18,98.71103,100,117.7998,118
8.169707,8,102.07912,102,110.418396,110
7.2026377,7,90.02431,90,96.837944,97
1.9112002,2,64.05028,64,67.15197,66
3.973637,4,55.987305,56,59.736763,60
2.9908235,3,51.022316,51,53.121235,54
0.2010839,0,32.00482,32,32.041054,32
0.10108346,0,41.008904,41,40.89386,41
1.0211083,1,26.999556,27,28.035904,28
0.2010839,0,18.999485,19,19.048239,19
1.0027133,1,14.000016,14,15.012938,15
0.0010849719,0,6.999994,7,6.9756284,7
0.0010849719,0,2.0058706,2,2.008239,2
0.9861201,1,6.999994,7,7.970931,8
0.10108346,0,13.000438,13,13.002387,13
0.98252475,1,32.00482,32,33.136448,33
8.710012,9,64.29889,65,74.23331,74
30.241627,31,91.07919,91,120.92659,122
32.691013,33,102.510956,103,135.32002,136
47.233253,47,97.63107,97,144.05174,144
49.126328,49,119.94211,120,170.00253,169
39.23653,39,121.59952,121,160.53241,160
36.846645,37,101.003174,101,138.28252,138
30.737894,31,102.09775,102,132.45161,133
24.68718,26,97.56546,97,122.81126,123
11.39329,12,112.48273,113,124.37856,125
15.800454,16,85.008224,86,101.95268,102
9.36233,9,61.784554,63,72.09282,72
4.945507,5,42.34012,42,47.089626,47
6.05033,6,30.000034,30,36.04046,36
9.422427,10,39.008095,39,48.983383,49
3.951472,4,30.000034,30,33.247177,34
5.878159,6,13.000438,13,19.05055,19
2.9832647,3,8.000006,8,11.046457,11
0.0010849719,0,2.0058706,1,0.9885795,1
0.0010849719,0,2.9569173,3,2.9961672,3
0.0010849719,0,8.999781,9,9.033489,9
0.0010849719,0,39.008095,40,39.64249,40
2.784924,2,83.51666,83,84.93196,85
9.569866,9,188.52142,187,196.79216,196
13.002412,13,144.8135,144,156.41579,157
33.282146,33,86.99153,87,119.47144,120
43.44423,43,113.79268,114,156.48283,157
46.529446,52,171.45917,172,224.50653,224
37.499825,38,164.95053,165,203.8147,203
55.79038,62,184.29083,185,245.29553,247
65.097855,69,247.09094,246,315.33783,315
29.509085,30,184.73514,184,214.00014,214
14.067136,14,150.81512,150,163.57101,164
9.550982,10,112.40134,112,121.239395,122
10.291511,11,108.34129,108,119.47187,119
7.8865795,8,81.014755,81,89.13109,89
6.9238486,7,83.41824,83,89.96409,90
12.310747,13,47.352478,48,61.07448,61
11.313716,12,37.546875,37,49.01789,49
